"filename", "language", "PHP", "JavaScript", "XML", "CSS", "Markdown", "comment", "blank", "total"
"c:\xampp\htdocs\commerce-app\README.md", "Markdown", 0, 0, 0, 0, 23, 0, 7, 30
"c:\xampp\htdocs\commerce-app\controllers\README.md", "Markdown", 0, 0, 0, 0, 1, 0, 0, 1
"c:\xampp\htdocs\commerce-app\controllers\controller_login.php", "PHP", 23, 0, 0, 0, 0, 2, 4, 29
"c:\xampp\htdocs\commerce-app\controllers\controller_payments.php", "PHP", 26, 0, 0, 0, 0, 0, 6, 32
"c:\xampp\htdocs\commerce-app\controllers\controller_products.php", "PHP", 67, 0, 0, 0, 0, 8, 15, 90
"c:\xampp\htdocs\commerce-app\controllers\controller_purchases.php", "PHP", 78, 0, 0, 0, 0, 7, 18, 103
"c:\xampp\htdocs\commerce-app\controllers\controller_signoff.php", "PHP", 5, 0, 0, 0, 0, 0, 1, 6
"c:\xampp\htdocs\commerce-app\controllers\controller_signup.php", "PHP", 22, 0, 0, 0, 0, 0, 0, 22
"c:\xampp\htdocs\commerce-app\controllers\controller_users.php", "PHP", 58, 0, 0, 0, 0, 1, 11, 70
"c:\xampp\htdocs\commerce-app\models\connection.php", "PHP", 4, 0, 0, 0, 0, 2, 2, 8
"c:\xampp\htdocs\commerce-app\views\about.php", "PHP", 118, 0, 0, 0, 0, 0, 11, 129
"c:\xampp\htdocs\commerce-app\views\account.php", "PHP", 155, 0, 0, 0, 0, 1, 27, 183
"c:\xampp\htdocs\commerce-app\views\css\Group 27.svg", "XML", 0, 0, 14, 0, 0, 0, 1, 15
"c:\xampp\htdocs\commerce-app\views\css\person.svg", "XML", 0, 0, 14, 0, 0, 0, 1, 15
"c:\xampp\htdocs\commerce-app\views\css\styles.css", "CSS", 0, 0, 0, 837, 0, 14, 56, 907
"c:\xampp\htdocs\commerce-app\views\css\user.svg", "XML", 0, 0, 11, 0, 0, 0, 1, 12
"c:\xampp\htdocs\commerce-app\views\developer_tasks.php", "PHP", 208, 0, 0, 0, 0, 7, 39, 254
"c:\xampp\htdocs\commerce-app\views\development_tasks.php", "PHP", 207, 0, 0, 0, 0, 7, 35, 249
"c:\xampp\htdocs\commerce-app\views\index.php", "PHP", 139, 0, 0, 0, 0, 1, 28, 168
"c:\xampp\htdocs\commerce-app\views\login.php", "PHP", 61, 0, 0, 0, 0, 3, 18, 82
"c:\xampp\htdocs\commerce-app\views\payments.php", "PHP", 238, 0, 0, 0, 0, 6, 40, 284
"c:\xampp\htdocs\commerce-app\views\products.php", "PHP", 203, 0, 0, 0, 0, 5, 28, 236
"c:\xampp\htdocs\commerce-app\views\purchases.php", "PHP", 196, 0, 0, 0, 0, 5, 29, 230
"c:\xampp\htdocs\commerce-app\views\purchases_client.php", "PHP", 159, 0, 0, 0, 0, 6, 26, 191
"c:\xampp\htdocs\commerce-app\views\script.js", "JavaScript", 0, 59, 0, 0, 0, 9, 26, 94
"c:\xampp\htdocs\commerce-app\views\signup.php", "PHP", 78, 0, 0, 0, 0, 3, 21, 102
"c:\xampp\htdocs\commerce-app\views\users.php", "PHP", 212, 0, 0, 0, 0, 5, 27, 244
"Total", "-", 2257, 59, 39, 837, 24, 92, 478, 3786